6 5 5 5 5 4 3 5 5 5 5 5 6
5 3 5 5 3 2 3 3 5 5 5 4 5
5 3 2 3 3 1 3 1 3 3 3 2 3
4 1 3 1 3 4 3 2 3 1 3 3 3
3 1 1 3 3 1 3 1 3 3 3 1 3
3 3 3 1 3 2 3 4 3 1 1 1 4
3 2 3 3 3 1 3 1 3 3 3 3 3
3 3 4 5 3 3 3 2 3 1 2 3 5
6 5 5 5 5 5 5 4 3 5 5 5 6
